[   ["@ ", "@ ", "@ ", "@ ", "@ ", "@ ", "@ ", "@ ", "@ ", "@ ", "@ ", "@ ", "@ ", "@ ", "@ ", "@ ", "@ ", "@ ", "@ ", "@ ", "@ ", "@ ", "@ ", "@ ", "@ ", "@ ", "@ ", "@ ", "@ ", "@ ", "@ ", "@ ", "@ "],
    ["@ ", "s ", "  ", "  ", "@ ", "  ", "  ", "  ", "@ ", "  ", "  ", "  ", "p ", "  ", "  ", "  ", "tl", "  ", "  ", "  ", "  ", "  ", "@ ", "  ", "@ ", "  ", "  ", "  ", "@ ", "  ", "  ", "  ", "@ "],
    ["@ ", "  ", "@ ", "  ", "@ ", "  ", "@ ", "  ", "@ ", "  ", "@ ", "@ ", "@ ", "@ ", "@ ", "@ ", "@ ", "@ ", "@ ", "@ ", "@ ", "  ", "  ", "  ", "@ ", "  ", "@ ", "  ", "  ", "  ", "@ ", "  ", "@ "],
    ["@ ", "  ", "@ ", "  ", "  ", "  ", "@ ", "  ", "@ ", "  ", "  ", "  ", "  ", "  ", "  ", "@ ", "  ", "  ", "  ", "  ", "@ ", "  ", "@ ", "@ ", "@ ", "  ", "@ ", "@ ", "@ ", "@ ", "@ ", "  ", "@ "],
    ["@ ", "p ", "@ ", "@ ", "@ ", "@ ", "@ ", "  ", "@ ", "  ", "@ ", "@ ", "@ ", "@ ", "  ", "@ ", "  ", "@ ", "@ ", "@ ", "@ ", "  ", "  ", "  ", "@ ", "  ", "  ", "  ", "  ", "  ", "@ ", "  ", "@ "],
    ["@ ", "  ", "@ ", "  ", "  ", "  ", "@ ", "  ", "@ ", "  ", "@ ", "  ", "  ", "  ", "  ", "@ ", "  ", "  ", "  ", "  ", "@ ", "@ ", "@ ", "  ", "@ ", "@ ", "@ ", "@ ", "@ ", "  ", "@ ", "  ", "@ "],
    ["@ ", "  ", "@ ", "  ", "@ ", "@ ", "@ ", "  ", "@ ", "@ ", "@ ", "  ", "@ ", "@ ", "@ ", "@ ", "@ ", "@ ", "@ ", "  ", "kr", "  ", "  ", "  ", "@ ", "  ", "  ", "  ", "@ ", "  ", "@ ", "@ ", "@ "],
    ["@ ", "  ", "@ ", "  ", "  ", "  ", "@ ", "  ", "p ", "  ", "  ", "  ", "kl", "@ ", "  ", "  ", "  ", "  ", "@ ", "@ ", "@ ", "@ ", "@ ", "  ", "@ ", "  ", "@ ", "  ", "@ ", "  ", "  ", "  ", "@ "],
    ["@ ", "  ", "@ ", "@ ", "  ", "  ", "@ ", "@ ", "@ ", "@ ", "@ ", "@ ", "  ", "@ ", "  ", "@ ", "@ ", "  ", "@ ", "  ", "  ", "  ", "@ ", "  ", "@ ", "td", "@ ", "  ", "@ ", "@ ", "@ ", "  ", "@ "],
    ["@ ", "  ", "  ", "  ", "  ", "  ", "  ", "@ ", "td", "  ", "  ", "@ ", "  ", "  ", "  ", "@ ", "  ", "  ", "@ ", "@ ", "  ", "  ", "@ ", "  ", "@ ", "  ", "@ ", "  ", "  ", "  ", "  ", "  ", "@ "],
    ["@ ", "  ", "@ ", "@ ", "@ ", "@ ", "  ", "@ ", "  ", "@ ", "@ ", "@ ", "  ", "@ ", "@ ", "@ ", "@ ", "@ ", "@ ", "@ ", "td", "@ ", "@ ", "  ", "@ ", "p ", "@ ", "@ ", "@ ", "@ ", "@ ", "@ ", "@ "],
    ["@ ", "  ", "@ ", "  ", "  ", "@ ", "  ", "@ ", "  ", "@ ", "  ", "  ", "  ", "@ ", "p ", "  ", "  ", "  ", "@ ", "  ", "  ", "  ", "@ ", "  ", "  ", "  ", "  ", "  ", "  ", "  ", "  ", "  ", "@ "],
    ["@ ", "  ", "  ", "  ", "  ", "@ ", "  ", "@ ", "  ", "  ", "  ", "@ ", "  ", "@ ", "  ", "@ ", "  ", "@ ", "@ ", "@ ", "@ ", "  ", "@ ", "@ ", "@ ", "@ ", "@ ", "@ ", "@ ", "  ", "  ", "@ ", "@ "],
    ["@ ", "  ", "  ", "@ ", "  ", "@ ", "  ", "@ ", "p ", "p ", "@ ", "@ ", "  ", "@ ", "  ", "@ ", "  ", "  ", "  ", "  ", "  ", "  ", "@ ", "  ", "  ", "  ", "  ", "  ", "@ ", "  ", "  ", "  ", "@ "], 
    ["@ ", "  ", "  ", "@ ", "  ", "@ ", "  ", "@ ", "  ", "  ", "  ", "  ", "  ", "@ ", "  ", "@ ", "@ ", "@ ", "@ ", "@ ", "@ ", "  ", "@ ", "@ ", "@ ", "@ ", "@ ", "  ", "@ ", "@ ", "@ ", "  ", "@ "],
    ["@ ", "  ", "@ ", "@ ", "@ ", "@ ", "  ", "@ ", "  ", "@ ", "@ ", "@ ", "@ ", "@ ", "  ", "@ ", "  ", "@ ", "  ", "  ", "@ ", "  ", "  ", "  ", "@ ", "  ", "  ", "  ", "  ", "  ", "@ ", "  ", "@ "], 
    ["@ ", "  ", "  ", "  ", "  ", "@ ", "  ", "@ ", "  ", "  ", "  ", "  ", "  ", "  ", "  ", "@ ", "  ", "  ", "  ", "@ ", "@ ", "  ", "@ ", "  ", "@ ", "  ", "  ", "  ", "@ ", "@ ", "@ ", "  ", "@ "],
    ["@ ", "  ", "@ ", "@ ", "  ", "@ ", "  ", "@ ", "  ", "  ", "  ", "@ ", "@ ", "@ ", "@ ", "@ ", "  ", "@ ", "  ", "  ", "@ ", "  ", "@ ", "p ", "@ ", "@ ", "@ ", "  ", "  ", "  ", "  ", "  ", "@ "], 
    ["@ ", "  ", "  ", "@ ", "  ", "@ ", "@ ", "@ ", "@ ", "@ ", "  ", "  ", "  ", "  ", "  ", "  ", "tl", "@ ", "@ ", "  ", "@ ", "  ", "@ ", "  ", "@ ", "  ", "kr", "  ", "  ", "  ", "@ ", "@ ", "@ "],
    ["@ ", "@ ", "  ", "@ ", "  ", "@ ", "  ", "  ", "  ", "@ ", "@ ", "@ ", "@ ", "@ ", "@ ", "@ ", "@ ", "@ ", "  ", "  ", "@ ", "  ", "@ ", "  ", "@ ", "@ ", "@ ", "@ ", "@ ", "  ", "  ", "  ", "@ "],
    ["@ ", "  ", "  ", "@ ", "  ", "@ ", "  ", "@ ", "  ", "@ ", "  ", "  ", "  ", "  ", "  ", "  ", "  ", "  ", "  ", "  ", "@ ", "  ", "@ ", "  ", "  ", "  ", "  ", "  ", "@ ", "@ ", "  ", "  ", "@ "],
    ["@ ", "  ", "@ ", "@ ", "  ", "@ ", "p ", "@ ", "  ", "@ ", "  ", "@ ", "  ", "@ ", "@ ", "@ ", "@ ", "@ ", "@ ", "kd", "  ", "  ", "@ ", "@ ", "@ ", "@ ", "@ ", "  ", "@ ", "  ", "p ", "@ ", "@ "],
    ["@ ", "  ", "  ", "@ ", "  ", "  ", "  ", "@ ", "  ", "@ ", "  ", "@ ", "  ", "  ", "  ", "  ", "  ", "  ", "@ ", "  ", "@ ", "@ ", "@ ", "  ", "  ", "  ", "@ ", "  ", "  ", "  ", "  ", "  ", "@ "], 
    ["@ ", "@ ", "  ", "@ ", "  ", "@ ", "@ ", "@ ", "  ", "@ ", "  ", "@ ", "@ ", "@ ", "@ ", "@ ", "@ ", "  ", "@ ", "  ", "@ ", "  ", "  ", "  ", "@ ", "@ ", "@ ", "@ ", "@ ", "@ ", "@ ", "  ", "@ "], 
    ["@ ", "  ", "  ", "@ ", "  ", "@ ", "tr", "  ", "  ", "@ ", "  ", "  ", "  ", "  ", "  ", "  ", "@ ", "  ", "@ ", "  ", "@ ", "@ ", "@ ", "  ", "  ", "  ", "  ", "  ", "  ", "  ", "@ ", "  ", "@ "], 
    ["@ ", "@ ", "  ", "@ ", "  ", "@ ", "  ", "@ ", "@ ", "@ ", "@ ", "@ ", "@ ", "@ ", "@ ", "  ", "@ ", "  ", "@ ", "  ", "@ ", "  ", "@ ", "  ", "@ ", "@ ", "@ ", "  ", "@ ", "@ ", "@ ", "  ", "@ "],
    ["@ ", "  ", "  ", "@ ", "  ", "@ ", "  ", "@ ", "  ", "  ", "  ", "@ ", "  ", "  ", "  ", "  ", "@ ", "  ", "@ ", "  ", "  ", "  ", "  ", "  ", "@ ", "  ", "  ", "  ", "@ ", "  ", "  ", "p ", "@ "], 
    ["@ ", "  ", "@ ", "@ ", "  ", "@ ", "  ", "@ ", "@ ", "@ ", "  ", "@ ", "  ", "@ ", "@ ", "@ ", "@ ", "  ", "@ ", "@ ", "  ", "@ ", "@ ", "@ ", "@ ", "  ", "@ ", "  ", "@ ", "  ", "@ ", "  ", "@ "],
    ["@ ", "  ", "@ ", "  ", "  ", "@ ", "  ", "  ", "  ", "@ ", "  ", "@ ", "  ", "  ", "  ", "  ", "@ ", "  ", "  ", "  ", "  ", "@ ", "  ", "  ", "  ", "  ", "@ ", "  ", "@ ", "  ", "@ ", "p ", "@ "],
    ["@ ", "  ", "@ ", "  ", "  ", "  ", "  ", "@ ", "  ", "@ ", "  ", "@ ", "ku", "@ ", "@ ", "@ ", "@ ", "@ ", "@ ", "@ ", "  ", "@ ", "  ", "@ ", "@ ", "@ ", "@ ", "@ ", "@ ", "@ ", "@ ", "  ", "@ "],
    ["@ ", "  ", "@ ", "@ ", "@ ", "@ ", "  ", "@ ", "  ", "  ", "  ", "@ ", "  ", "  ", "  ", "  ", "@ ", "  ", "  ", "  ", "  ", "@ ", "  ", "  ", "@ ", "  ", "  ", "  ", "  ", "  ", "  ", "p ", "@ "], 
    ["@ ", "ku", "  ", "  ", "  ", "@ ", "  ", "@ ", "@ ", "@ ", "@ ", "@ ", "  ", "@ ", "@ ", "  ", "@ ", "  ", "@ ", "@ ", "  ", "@ ", "@ ", "  ", "@ ", "@ ", "@ ", "@ ", "@ ", "@ ", "@ ", "b ", "@ "],
    ["@ ", "@ ", "@ ", "@ ", "@ ", "@ ", "@ ", "@ ", "@ ", "@ ", "@ ", "@ ", "@ ", "@ ", "@ ", "@ ", "@ ", "@ ", "@ ", "@ ", "@ ", "@ ", "@ ", "@ ", "@ ", "@ ", "@ ", "@ ", "@ ", "@ ", "@ ", "@ ", "@ "]]
